//MAP CONVERTED BY dmm2tgm.py THIS HEADER COMMENT PREVENTS RECONVERSION, DO NOT REMOVE
"a" = (
/turf/open/indestructible/dark,
/area/misc/survivalpod/singulo_box)
"b" = (
/obj/machinery/power/rad_collector,
/obj/structure/cable,
/turf/open/floor/plating,
/area/misc/survivalpod/singulo_box)
"c" = (
/obj/machinery/atmospherics/pipe/smart/manifold4w/supply/hidden/layer4,
/obj/machinery/light/directional/east,
/turf/open/floor/plating,
/area/misc/survivalpod/singulo_box)
"d" = (
/obj/machinery/door/airlock/engineering/glass/critical{
	heat_proof = 1;
	name = "Singularity Chamber"
	},
/obj/structure/cable,
/obj/machinery/atmospherics/pipe/smart/manifold4w/supply/hidden/layer4,
/obj/machinery/atmospherics/pipe/smart/manifold4w/scrubbers/hidden/layer2,
/obj/structure/fans/tiny,
/turf/open/floor/plating,
/area/misc/survivalpod/singulo_box)
"e" = (
/obj/structure/particle_accelerator/fuel_chamber,
/turf/open/floor/plating,
/area/misc/survivalpod/singulo_box)
"h" = (
/obj/machinery/atmospherics/pipe/smart/manifold4w/supply/hidden/layer4,
/obj/machinery/atmospherics/pipe/smart/manifold4w/scrubbers/hidden/layer2,
/turf/open/floor/plating,
/area/misc/survivalpod/singulo_box)
"i" = (
/obj/machinery/power/smes/engineering,
/obj/machinery/atmospherics/components/unary/vent_pump/on/layer4,
/turf/open/floor/plating,
/area/misc/survivalpod/singulo_box)
"j" = (
/obj/structure/cable,
/turf/open/floor/plating,
/area/misc/survivalpod/singulo_box)
"k" = (
/obj/structure/cable,
/obj/machinery/power/apc/sm_apc/directional/west{
	arc_shielded = 1;
	pixel_y = -4
	},
/obj/machinery/atmospherics/pipe/smart/manifold4w/supply/hidden/layer4,
/obj/machinery/atmospherics/pipe/smart/manifold4w/scrubbers/hidden/layer2,
/obj/machinery/light_switch/directional/west{
	pixel_y = 8
	},
/turf/open/floor/plating,
/area/misc/survivalpod/singulo_box)
"l" = (
/obj/machinery/power/emitter/welded{
	dir = 4
	},
/obj/structure/cable,
/obj/structure/window/reinforced/plasma/spawner{
	dir = 8
	},
/turf/open/floor/plating,
/area/misc/survivalpod/singulo_box)
"m" = (
/obj/machinery/power/rad_collector,
/obj/structure/window/reinforced/plasma/spawner{
	dir = 8
	},
/obj/structure/cable,
/turf/open/floor/plating,
/area/misc/survivalpod/singulo_box)
"n" = (
/turf/closed/wall/r_wall,
/area/misc/survivalpod/singulo_box)
"o" = (
/obj/structure/particle_accelerator/particle_emitter/left,
/obj/machinery/atmospherics/pipe/smart/manifold4w/supply/hidden/layer4,
/obj/machinery/atmospherics/pipe/smart/manifold4w/scrubbers/hidden/layer2,
/turf/open/floor/plating,
/area/misc/survivalpod/singulo_box)
"p" = (
/obj/machinery/power/terminal{
	dir = 1
	},
/obj/structure/cable,
/obj/machinery/atmospherics/pipe/smart/manifold4w/supply/hidden/layer4,
/turf/open/floor/plating,
/area/misc/survivalpod/singulo_box)
"q" = (
/obj/machinery/atmospherics/pipe/smart/manifold4w/supply/hidden/layer4,
/obj/machinery/atmospherics/pipe/smart/manifold4w/scrubbers/hidden/layer2,
/obj/machinery/power/rad_collector,
/obj/structure/cable,
/turf/open/floor/plating,
/area/misc/survivalpod/singulo_box)
"r" = (
/obj/machinery/power/rad_collector,
/obj/structure/window/reinforced/plasma/spawner{
	dir = 4
	},
/obj/structure/window/reinforced/plasma/spawner{
	dir = 1
	},
/obj/structure/cable,
/turf/open/floor/plating,
/area/misc/survivalpod/singulo_box)
"s" = (
/obj/structure/cable,
/obj/machinery/atmospherics/pipe/smart/manifold4w/supply/hidden/layer4,
/obj/machinery/light/directional/west,
/turf/open/floor/plating,
/area/misc/survivalpod/singulo_box)
"t" = (
/obj/structure/cable,
/obj/machinery/atmospherics/pipe/smart/manifold4w/supply/hidden/layer4,
/obj/machinery/atmospherics/pipe/smart/manifold4w/scrubbers/hidden/layer2,
/obj/machinery/light/floor,
/turf/open/floor/plating,
/area/misc/survivalpod/singulo_box)
"u" = (
/obj/structure/particle_accelerator/particle_emitter/center,
/obj/machinery/atmospherics/pipe/smart/manifold4w/supply/hidden/layer4,
/obj/machinery/atmospherics/pipe/smart/manifold4w/scrubbers/hidden/layer2,
/turf/open/floor/plating,
/area/misc/survivalpod/singulo_box)
"v" = (
/obj/machinery/atmospherics/pipe/smart/manifold4w/supply/hidden/layer4,
/turf/open/floor/plating,
/area/misc/survivalpod/singulo_box)
"w" = (
/obj/structure/particle_accelerator/particle_emitter/right,
/obj/machinery/atmospherics/pipe/smart/manifold4w/supply/hidden/layer4,
/obj/machinery/atmospherics/pipe/smart/manifold4w/scrubbers/hidden/layer2,
/turf/open/floor/plating,
/area/misc/survivalpod/singulo_box)
"y" = (
/obj/machinery/field/generator/anchored,
/obj/structure/cable,
/turf/open/indestructible/dark,
/area/misc/survivalpod/singulo_box)
"z" = (
/obj/structure/tank_dispenser/plasma,
/turf/open/floor/plating,
/area/misc/survivalpod/singulo_box)
"A" = (
/obj/structure/window/reinforced/plasma/spawner{
	dir = 1
	},
/turf/open/floor/plating,
/area/misc/survivalpod/singulo_box)
"B" = (
/obj/structure/cable,
/obj/machinery/atmospherics/components/unary/vent_scrubber/on/layer2{
	dir = 1
	},
/turf/open/floor/plating,
/area/misc/survivalpod/singulo_box)
"C" = (
/obj/structure/cable,
/obj/machinery/power/rad_collector,
/turf/open/floor/plating,
/area/misc/survivalpod/singulo_box)
"D" = (
/obj/effect/spawner/structure/window/reinforced/plasma,
/turf/open/floor/plating,
/area/misc/survivalpod/singulo_box)
"E" = (
/obj/structure/cable,
/obj/machinery/atmospherics/components/unary/vent_pump/on/layer4{
	dir = 1
	},
/turf/open/floor/plating,
/area/misc/survivalpod/singulo_box)
"F" = (
/obj/structure/cable,
/obj/machinery/atmospherics/pipe/smart/manifold4w/supply/hidden/layer4,
/obj/machinery/atmospherics/pipe/smart/manifold4w/scrubbers/hidden/layer2,
/turf/open/floor/plating,
/area/misc/survivalpod/singulo_box)
"G" = (
/obj/machinery/particle_accelerator/control_box,
/turf/open/floor/plating,
/area/misc/survivalpod/singulo_box)
"H" = (
/obj/structure/window/reinforced/plasma/spawner{
	dir = 1
	},
/obj/structure/cable,
/turf/open/floor/plating,
/area/misc/survivalpod/singulo_box)
"I" = (
/obj/structure/cable,
/obj/machinery/atmospherics/pipe/smart/manifold4w/supply/hidden/layer4,
/turf/open/floor/plating,
/area/misc/survivalpod/singulo_box)
"J" = (
/obj/machinery/power/rad_collector,
/obj/structure/window/reinforced/plasma/spawner{
	dir = 8
	},
/obj/structure/window/reinforced/plasma/spawner{
	dir = 1
	},
/obj/structure/cable,
/turf/open/floor/plating,
/area/misc/survivalpod/singulo_box)
"K" = (
/obj/machinery/the_singularitygen,
/turf/open/indestructible/dark,
/area/misc/survivalpod/singulo_box)
"L" = (
/obj/machinery/power/smes/engineering,
/obj/machinery/atmospherics/components/unary/vent_scrubber/on/layer2,
/turf/open/floor/plating,
/area/misc/survivalpod/singulo_box)
"M" = (
/obj/structure/window/reinforced/plasma/spawner{
	dir = 4
	},
/obj/machinery/power/rad_collector,
/obj/structure/cable,
/turf/open/floor/plating,
/area/misc/survivalpod/singulo_box)
"N" = (
/obj/structure/particle_accelerator/power_box,
/turf/open/floor/plating,
/area/misc/survivalpod/singulo_box)
"O" = (
/obj/machinery/atmospherics/pipe/smart/manifold4w/scrubbers/hidden/layer2,
/turf/open/floor/plating,
/area/misc/survivalpod/singulo_box)
"Q" = (
/obj/machinery/atmospherics/pipe/smart/manifold4w/scrubbers/hidden/layer2,
/obj/machinery/light/directional/west,
/turf/open/floor/plating,
/area/misc/survivalpod/singulo_box)
"S" = (
/turf/open/floor/plating,
/area/misc/survivalpod/singulo_box)
"T" = (
/obj/structure/particle_accelerator/end_cap,
/turf/open/floor/plating,
/area/misc/survivalpod/singulo_box)
"U" = (
/obj/machinery/power/terminal{
	dir = 1
	},
/obj/structure/cable,
/obj/machinery/atmospherics/pipe/smart/manifold4w/scrubbers/hidden/layer2,
/turf/open/floor/plating,
/area/misc/survivalpod/singulo_box)
"V" = (
/obj/structure/cable,
/obj/machinery/atmospherics/pipe/smart/manifold4w/scrubbers/hidden/layer2,
/turf/open/floor/plating,
/area/misc/survivalpod/singulo_box)
"W" = (
/obj/structure/window/reinforced/plasma/spawner{
	dir = 8
	},
/obj/machinery/power/rad_collector,
/obj/structure/cable,
/turf/open/floor/plating,
/area/misc/survivalpod/singulo_box)
"X" = (
/obj/machinery/power/rad_collector,
/obj/structure/window/reinforced/plasma/spawner{
	dir = 4
	},
/obj/structure/cable,
/turf/open/floor/plating,
/area/misc/survivalpod/singulo_box)
"Y" = (
/obj/structure/cable,
/obj/machinery/atmospherics/pipe/smart/manifold4w/scrubbers/hidden/layer2,
/obj/machinery/light/directional/east,
/turf/open/floor/plating,
/area/misc/survivalpod/singulo_box)
"Z" = (
/obj/machinery/power/emitter/welded{
	dir = 8
	},
/obj/structure/cable,
/obj/structure/window/reinforced/plasma/spawner{
	dir = 4
	},
/turf/open/floor/plating,
/area/misc/survivalpod/singulo_box)

(1,1,1) = {"
n
n
n
n
n
l
n
d
J
m
m
W
W
l
n
"}
(2,1,1) = {"
n
i
p
s
F
F
k
t
V
O
O
Q
O
B
n
"}
(3,1,1) = {"
n
z
S
C
q
y
a
a
a
a
a
a
a
y
n
"}
(4,1,1) = {"
n
z
S
b
h
a
a
a
a
a
a
a
a
a
n
"}
(5,1,1) = {"
A
j
j
b
h
a
a
a
a
a
a
a
a
a
n
"}
(6,1,1) = {"
H
C
G
S
o
a
a
a
a
a
a
a
a
a
D
"}
(7,1,1) = {"
H
T
e
N
u
a
a
a
a
K
a
a
a
a
D
"}
(8,1,1) = {"
H
C
S
S
w
a
a
a
a
a
a
a
a
a
D
"}
(9,1,1) = {"
A
j
j
b
h
a
a
a
a
a
a
a
a
a
n
"}
(10,1,1) = {"
n
z
S
b
h
a
a
a
a
a
a
a
a
a
n
"}
(11,1,1) = {"
n
z
S
C
q
y
a
a
a
a
a
a
a
y
n
"}
(12,1,1) = {"
n
L
U
Y
F
F
F
t
I
v
v
c
v
E
n
"}
(13,1,1) = {"
n
n
n
n
n
Z
n
d
r
X
X
M
M
Z
n
"}
